111111111111111111111100111111111111111111111111111110011111111111111
100000001000000000000000000000000000000100000000000000000000000000001
100000001000000000000000000000000000000100000000000000000000000000001
100000001000000000000000000000000000000100000000000000000000000000001
100000001000000000000000000000000000000100000000000000000000000000001
100000001000000000000000000000000000000100000000000000000000000000001
100000001000000000000000000000000000000100000000000000000000000000001
100000000000000000000000000000000000000000000000000000000000000000000
100000000000000000000000000000000000000000000000000000000000000000000
100000001000000000000000000000000000000100000000000000000000000000001
100000001000000000000000000000000000000100000000000000000000000000001
100000001000000000000000000000000000000100000000000000000000000000001
100000001000000000000000000000000000000100000000000000000000000000001
100000001000000000000000000000000000000100000000000000000000000000001
100000001000000000000000000000000000000100000000000000000000000000001
100000001000000000000000000000000000000100000000000000000000000000001
100000001000000000000000000000000000000100000000000000000000000000001
111111111111111111111100111111111111111111111111111110011111111111111
000000001000000000000111100000000000000100000000000000000000000000001
000000001000000000000000000000000000000100000000000000000000000000001
000000001000000000000000000000000000000100000000000000000000000000001
000000001000000000000000000000000000000100000000000000000000000000001
000000001000000000000000000000000000000100000000000000000000000000001
000000001000000000000000000000000000000100000000000000000000000000001
000000001000000000000000000000000000000100000000000000000000000000001
000000000000000000000000000000000000000000000000000000000000000000000
000000000000000000000000000000000000000000000000000000000000000000000
000000001000000000000000000000000000000100000000000000000000000000001
000000001000000000000000000000000000000100000000000000000000000000001
000000001000000000000000000000000000000100000000000000000000000000001
000000001000000000000000000000000000000100000000000000000000000000001
000000001000000000000000000000000000000100000000000000000000000000001
000000001000000000000000000000000000000100000000000000000000000000001
000000001000000000000000000000000000000100000000000000000000000000001
111111111111111111111111111111111111111111111111111111001111111111111