1111111111111111111111111111111111111111
0000000010000000000000000000000000000001
0000000010000000000000000000000000000001
0000000010000000000000000000000000000001
0000000010000000000000000000000000000001
0000000010000000000000000000000000000001
0000000010000000000000000000000000000001
0000000000000000000000000000000000000001
0000000000000000000000000000000000000001
0000000010000000000000000000000000000001
0000000010000000000000000000000000000001
0000000010000000000000000000000000000001
0000000010000000000000000000000000000001
0000000010000000000000000000000000000001
0000000010000000000000000000000000000001
0000000010000000000000000000000000000001
0000000010000000000000000000000000000001
1111111111111111111111100111111111111111
0000000010000000000000000000000000000001
0000000010000000000000000000000000000001
0000000010000000000000000000000000000001
0000000010000000000000000000000000000001
0000000010000000000000000000000000000001
0000000010000000000000000000000000000001
0000000000000000000000000000000000000001
0000000000000000000000000000000000000001
0000000010000000000000000000000000000001
0000000010000000000000000000000000000001
0000000010000000000000000000000000000001
0000000010000000000000000000000000000001
0000000010000000000000000000000000000001
0000000010000000000000000000000000000001
0000000010000000000000000000000000000001
0000000010000000000000000000000000000001
1111111111111111111111111111111111111111