111111111111111111111
100000100000000000001
100000100000000000001
100000100111100000001
100000100100000000001
100000100100000000001
100000111111100000001
100000000000100000001
100000000000100000001
100000111100110011001
100000100100000000001
100000100100000000001
100000100100000000001
100000100100000000001
100000000100000000001
100000000100000000001
111111111111111111111