11111111111111111111110011111111111111111111111111111001111111111111111
00000000100000000000000000000000000000010000000000000000000000000000001
00000000100000000000000000000000000000010000000000000000000000000000001
00000000100000000000000000000000000000010000000000000000000000000000001
00000000100000000000000000000000000000010000000000000000000000000000001
00000000100000000000000000000000000000010000000000000000000000000000001
00000000100000000000000000000000000000010000000000000000000000000000001
0000000000000000000000000000000000000000
0000000000000000000000000000000000000000
00000000100000000000000000000000000000010000000000000000000000000000001
00000000100000000000000000000000000000010000000000000000000000000000001
00000000100000000000000000000000000000010000000000000000000000000000001
00000000100000000000000000000000000000010000000000000000000000000000001
00000000100000000000000000000000000000010000000000000000000000000000001
00000000100000000000000000000000000000010000000000000000000000000000001
00000000100000000000000000000000000000010000000000000000000000000000001
00000000100000000000000000000000000000010000000000000000000000000000001
11111111111111111111111001111111111111111111111111111100111111111111111
00000000100000000000000000000000000000010000000000000000000000000000001
00000000100000000000000000000000000000010000000000000000000000000000001
00000000100000000000000000000000000000010000000000000000000000000000001
00000000100000000000000000000000000000010000000000000000000000000000001
00000000100000000000000000000000000000010000000000000000000000000000001
00000000100000000000000000000000000000010000000000000000000000000000001
00000000000000000000000000000000000000010000000000000000000000000000001
00000000000000000000000000000000000000010000000000000000000000000000001
00000000100000000000000000000000000000010000000000000000000000000000001
00000000100000000000000000000000000000010000000000000000000000000000001
00000000100000000000000000000000000000010000000000000000000000000000001
00000000100000000000000000000000000000010000000000000000000000000000001
00000000100000000000000000000000000000010000000000000000000000000000001
00000000100000000000000000000000000000010000000000000000000000000000001
00000000100000000000000000000000000000010000000000000000000000000000001
00000000100000000000000000000000000000010000000000000000000000000000001
11111111111111111111111111111111111111111111111111111100111111111111111